WWWWWWWWWW
WMMMBOOODW
WDMMMMMBBW
WMMMB0BDMW
WMMMMMMMMW
WMMMDDMMMW
WOOMMBBMMW
WMMWWMMMMW
WWWWMMMMMW
WWWWWWWWWW