MMMMMMMMMMMMMMMMMMMMMMMMMMM
MWWWWWWWWWWWWWWWWWWWWWWWWWM
MW0000000000W0000000000WDWM
MW0P00000000W0000000000WMWM
MWWWW0000000W0000000000WMWM
MW0000000000W0000000000W0WM
MW0000000000W0000000000W0WM
MW0000000000W0000000000W0WM
MW0000000000W0000000000W0WM
MW0000000000W0000000000W0WM
MW0000000000W0000000000W0WM
MW0000000000W0000000000W0WM
MW0000000000W0000000D00W0WM
MWMMMWWWWWWWWWWWWWWMMMMW0WM
MWDM000000000000000000000WM
MWMM000000000000000000000WM
MW00000000000000000000000WM
MW00000000000000000000000WM
MW00000000000000000000000WM
MW00000000000D00000000000WM
MW0000000000BB00B0000000WWM
MW0000W00WWWWWWWWWWBWW0WDWM
MW0000W000000000000B00WMMWM
MW0000W000000000000B0W000WM
MW0000W000000000000B00000WM
MWWWWWWWWWWWWWWWWWWWWWWWWWM
MMMMMMMMMMMMMMMMMMMMMMMMMMM