MMMMMMMMMM
MWWWWWWWWM
MW000000WM
MW000000WM
MW000000WM
MW000000WM
MW000000WM
MW000000WM
MWWWWWWWWM
MMMMMMMMMM