WWWWWWWWWWWWWWW
WDMMMMWMMM0MMDW
WMMD00WWWM0MDMW
WMMWBMW00BBBWWW
WMMWMBWWWMMMMMW
W0BWMMWMMMMMWWW
WMMWMBW0000000W
W0DWMMW00000BBW
WMMWBMWMMWWWMMW
W00WMMWBMWDMMMW
W00W00WMMWWWMMW
W00W0000000000W
W0MW00W0000000W
WPMW00W0000000W
WWWWWWWWWWWWWWW